**********
*        *
* *****  *
* *    *  *
* *     **
* * ******
  *      *
* * ******
*        *
**********
