**********
*        *
* ****** *
* **   * *
* ** * * *
* ** * *  *
   * * * *
* ** * * *
*    *   *
**********
