**********
*        *
* * *** **
* *   * **
**  * * **
** ** * **
   *  **  *
**** * * *
*        *
**********
